#######################################################
#         ###                           #             #
#         ###          #                #             #
######                 ##               #       #     #
#         ########     ###        ###   ####   ###    #
#                      #          #             #     #
#  ####                #     ######                   #
#     #      #####     #     ######       #           #
#     #      ##        #     ######       #     ##    #
#            ##                           #     ##    #
######    #####                      #    #  ##########
#             #       #####          #                #
#             #       #####    #######                #
#     ####            #####          #   ####   #     #
#        #        #                  #   #      ##### #
#        #        #                      #            #
#  ###   #        ######       ######    #            #
#  ###        #        #       ######         #   #   #
#  ###        #        ####    #    #         #   #   #
#  ###        #    #   ####    #    ######    #   #   #
#        ######    #                          #       #
#                  #                          #       #
#######################################################
